47,47,47,47,47,47,47,47,47,47,47,47,47,47,47,47,47,47,47,47,47,47,47,47,47,47,47,47,47,47,47,47,
17,18,69,70,69,70,69,70,69,70,69,70,69,70,69,70,69,70,69,70,69,70,69,70,69,70,69,70,69,70,17,18,
25,26,77,78,77,78,77,78,77,78,77,78,77,78,77,78,77,78,77,78,77,78,77,78,77,78,77,78,77,78,25,26,
17,18,65,66,65,66,65,66,65,66,65,66,65,66,65,66,65,66,65,66,65,66,65,66,65,66,65,66,65,66,17,18,
25,26,73,74,73,74,73,74,73,74,73,74,73,74,73,74,73,74,73,74,73,74,73,74,73,74,73,74,73,74,25,26,
17,18,65,66,65,66,65,66,65,66,65,66,65,66,65,66,65,66,65,66,65,66,65,66,65,66,65,66,65,66,17,18,
25,26,73,74,73,74,73,74,73,74,73,74,73,74,73,74,73,74,73,74,73,74,73,74,73,74,73,74,73,74,25,26,
17,18,65,66,65,66,65,66,65,66,65,66,65,66,65,66,65,66,65,66,65,66,65,66,65,66,65,66,65,66,17,18,
25,26,73,74,73,74,73,74,73,74,73,74,73,74,73,74,73,74,73,74,73,74,73,74,73,74,73,74,73,74,25,26,
17,18,65,66,65,66,65,66,65,66,65,66,65,66,65,66,65,66,65,66,65,66,65,66,65,66,65,66,65,66,17,18,
25,26,73,74,73,74,73,74,73,74,73,74,73,74,73,74,73,74,73,74,73,74,73,74,73,74,73,74,73,74,25,26,
17,18,65,66,65,66,65,66,65,66,65,66,65,66,65,66,65,66,65,66,65,66,65,66,65,66,65,66,65,66,17,18,
25,26,73,74,73,74,73,74,73,74,73,74,73,74,73,74,73,74,73,74,73,74,73,74,73,74,73,74,73,74,25,26,
17,18,71,72,71,72,71,72,71,72,71,72,71,72,71,72,71,72,71,72,71,72,71,72,71,72,71,72,71,72,17,18,
25,26,79,80,79,80,79,80,79,80,79,80,79,80,79,80,79,80,79,80,79,80,79,80,79,80,79,80,79,80,25,26,
17,18,47,47,47,47,47,47,47,47,47,47,47,47,47,47,47,47,47,47,47,47,47,47,47,47,47,47,47,47,17,18,
25,26,12,0,0,0,0,0,0,0,0,0,0,0,0,0,0,0,0,0,0,0,0,0,0,0,0,0,0,12,25,26,
17,18,0,0,0,0,0,0,0,0,0,0,0,0,0,0,0,0,0,0,0,0,0,0,0,0,0,0,0,0,17,18,
25,26,0,0,0,0,0,0,0,0,33,34,35,36,37,38,37,37,37,37,38,0,0,0,0,0,0,0,0,0,25,26,
17,18,0,0,0,0,0,0,0,0,41,42,43,44,45,46,37,45,37,37,38,0,0,0,0,0,0,0,0,0,17,18,
25,26,0,0,0,0,0,0,0,0,49,50,51,52,53,54,37,45,37,45,46,0,0,0,0,0,0,0,0,0,25,26,
17,18,0,0,0,0,0,0,0,0,57,58,59,60,61,62,45,45,45,45,46,0,0,0,0,0,0,0,0,0,17,18,
25,26,0,0,0,0,0,0,0,0,47,47,47,47,47,47,47,47,47,47,47,0,0,0,0,0,0,0,0,0,25,26,
17,18,0,0,0,0,0,0,0,0,0,0,0,0,0,0,0,0,0,0,0,0,0,0,0,0,0,0,0,0,17,18,
25,26,0,0,0,0,0,0,0,0,0,0,0,0,0,0,0,0,0,0,0,0,0,0,0,0,0,0,0,0,25,26,
17,18,0,0,0,0,0,0,0,0,0,0,0,0,0,0,0,0,0,0,0,0,0,0,0,0,0,0,0,0,17,18,
25,26,0,0,0,0,0,0,0,0,0,0,0,0,0,0,0,0,0,0,0,0,0,0,0,0,0,0,0,0,25,26,
17,18,0,0,0,0,0,0,0,0,85,0,0,0,0,0,0,0,0,0,0,86,0,0,0,0,0,0,0,0,17,18,
25,26,0,0,0,0,0,0,0,0,48,0,0,0,0,0,0,0,0,0,0,48,0,0,0,0,0,0,0,0,25,26,
17,18,4,0,0,0,0,0,0,0,40,0,0,0,0,0,0,0,0,0,0,40,0,0,0,0,0,0,0,3,17,18,
47,47,3,4,3,4,3,4,3,4,3,5,6,7,8,4,3,7,8,4,5,6,3,4,3,4,3,4,3,4,47,47,
39,12,11,12,11,12,11,12,11,12,11,13,14,15,16,12,11,15,16,12,13,14,11,12,11,12,11,12,11,12,11,39