67,68,47,47,47,47,47,47,47,47,69,70,65,66,47,47,47,47,47,47,47,47,47,47,47,47,47,47,47,55,56,17,18,17,18,55,56,17,18,121,122,121,122,121,122,121,122,123,121,122,121,122,48,48,48,48,48,48,48,49,50,51,52,53,
75,76,0,0,0,0,47,47,0,0,77,78,73,74,0,0,123,121,122,0,48,0,48,0,0,0,0,0,113,63,64,25,26,25,26,63,64,25,26,0,0,0,0,0,0,0,0,0,0,0,0,0,0,0,0,0,0,0,0,57,58,59,60,61,
71,72,0,0,0,0,0,0,0,0,0,0,0,0,0,0,0,0,0,0,0,0,48,0,0,0,0,0,107,19,20,17,18,55,56,19,20,17,18,0,0,0,0,0,0,0,0,0,0,0,0,0,0,0,0,0,0,0,47,47,47,47,47,47,
79,80,0,0,0,0,0,0,0,0,0,0,0,0,0,0,0,0,0,89,90,0,48,0,0,0,0,0,105,27,28,25,26,63,64,27,28,25,26,0,0,0,0,0,0,0,0,0,0,0,0,0,0,0,0,0,0,0,0,0,0,0,0,48,
65,66,0,0,0,0,0,0,0,0,0,0,0,0,0,0,0,0,0,33,34,35,36,37,38,0,0,0,47,47,47,47,47,47,47,47,47,47,47,47,0,0,0,0,0,0,0,0,0,0,0,0,0,0,0,0,0,0,0,0,0,0,0,48,
73,74,0,0,0,0,0,0,0,0,0,0,0,0,0,0,0,0,0,41,42,43,44,45,46,0,0,0,0,0,48,0,0,0,0,0,39,0,0,0,0,0,0,0,0,0,0,0,0,0,0,0,0,0,0,0,0,0,0,0,0,0,0,48,
65,66,47,47,0,0,0,0,0,0,0,0,0,0,0,0,0,0,0,49,50,51,52,53,54,0,0,0,0,0,48,0,0,0,0,0,0,0,0,0,0,0,0,0,0,0,0,0,0,0,0,0,0,0,0,0,0,0,0,0,0,0,0,48,
73,48,0,0,0,0,0,0,0,0,77,0,0,0,0,74,0,0,0,57,58,59,60,61,62,0,0,0,0,0,0,0,0,0,0,0,0,0,0,0,0,0,0,0,0,0,0,0,0,0,0,0,0,0,0,0,0,0,0,0,0,21,22,23,
69,48,0,0,0,0,0,0,0,0,67,68,71,72,65,66,0,0,0,47,47,47,47,47,47,0,0,0,0,0,0,0,0,0,0,0,0,0,0,0,0,0,0,0,0,0,0,0,0,0,0,0,0,0,0,0,0,0,0,0,0,29,30,31,
77,78,0,0,0,0,0,0,47,47,75,76,79,80,73,48,0,0,0,0,48,0,0,0,0,0,0,0,0,0,0,0,85,86,0,0,0,0,0,0,0,0,103,104,103,104,0,0,0,0,0,0,0,0,0,0,0,0,0,0,119,120,119,120,
69,21,22,23,24,0,0,0,0,0,69,70,69,70,71,0,0,0,0,0,48,0,48,0,0,0,0,0,47,47,47,47,47,47,47,47,47,47,47,47,47,47,111,112,111,112,0,0,0,0,0,0,0,0,0,0,0,0,0,0,117,118,117,118,
77,29,30,31,32,0,0,0,0,0,77,78,77,78,79,0,0,0,0,33,34,35,36,37,48,0,0,0,0,48,0,0,0,48,121,122,39,121,122,0,121,122,103,104,103,104,0,0,0,0,0,0,0,0,0,0,0,0,0,0,125,126,125,126,
67,68,65,48,0,0,0,0,65,66,65,66,67,68,65,66,0,0,0,41,42,43,44,48,0,0,0,0,0,48,0,0,0,40,0,0,39,0,0,0,0,0,111,112,111,112,0,0,0,0,0,0,0,0,0,0,0,0,0,0,117,118,117,118,
75,76,73,74,0,0,0,0,0,74,73,74,75,76,73,74,0,0,0,49,50,51,52,53,0,0,0,0,21,22,23,24,0,48,0,0,0,0,0,0,0,0,103,104,103,104,96,96,96,96,0,0,0,0,0,0,83,84,0,0,125,126,125,126,
65,66,69,70,0,0,0,40,40,66,65,66,69,70,69,70,0,0,0,57,58,59,60,61,62,0,0,0,29,30,31,32,0,48,0,0,0,0,0,0,0,0,111,112,111,112,0,0,0,96,96,0,0,0,96,96,96,96,96,96,117,118,117,118,
73,74,77,78,79,0,0,0,0,74,73,74,77,78,77,78,0,0,0,47,47,47,47,47,47,0,0,0,0,0,0,0,0,48,0,48,0,0,0,0,0,0,119,120,119,120,0,0,48,0,0,0,0,0,0,40,0,0,40,0,125,126,125,126,
69,70,0,0,0,0,0,0,0,113,65,66,65,66,69,70,0,0,0,0,121,122,121,122,0,0,0,0,0,0,0,0,0,48,0,48,0,0,0,0,0,0,127,128,127,128,0,48,0,0,0,0,0,0,0,40,0,0,0,0,119,120,119,120,
77,78,0,0,0,0,0,0,0,107,73,74,73,74,77,78,0,0,0,0,0,0,0,0,0,0,0,0,0,0,0,0,47,47,47,47,47,47,47,47,47,47,103,104,103,104,48,0,0,0,0,0,0,0,0,40,0,0,0,0,127,128,127,128,
71,72,0,0,0,0,0,0,0,105,69,70,65,66,0,39,0,0,0,0,0,0,0,0,0,0,0,0,0,0,0,0,113,48,0,48,0,0,0,0,0,0,111,112,111,112,0,0,0,0,0,0,0,0,0,0,0,0,0,47,47,47,47,47,
79,48,0,0,0,0,0,0,0,113,77,78,73,74,0,39,0,0,0,0,0,0,0,0,0,0,0,0,0,0,0,0,107,48,0,40,0,0,0,0,0,47,47,47,47,47,47,0,0,0,0,0,0,0,0,0,0,0,0,0,0,113,73,74,
71,48,0,0,0,0,0,0,0,105,39,0,71,72,67,68,0,0,0,0,0,0,0,0,0,0,0,0,0,0,0,0,105,40,0,48,0,0,0,0,0,0,121,122,121,122,0,0,0,0,0,0,0,0,0,0,0,0,0,0,0,105,65,66,
79,80,0,0,0,0,0,48,48,48,39,0,0,80,75,76,94,95,0,0,0,0,0,0,0,0,0,0,0,0,0,0,113,40,0,0,0,0,0,0,0,0,0,0,0,0,0,0,0,0,0,0,0,0,0,0,0,0,0,0,0,113,73,74,
67,68,0,0,0,0,0,0,0,0,39,0,0,66,0,48,121,122,0,0,0,0,0,0,0,0,0,0,0,0,0,0,0,40,0,0,0,0,0,0,0,0,0,0,0,0,0,0,0,0,0,0,0,0,0,0,0,0,0,0,0,107,65,66,
75,76,0,0,0,0,0,0,0,0,0,0,0,40,0,48,0,0,0,0,0,0,0,0,99,0,0,0,0,0,0,0,0,48,0,0,0,0,0,0,0,0,0,0,0,0,0,0,0,92,93,0,103,104,103,104,0,0,0,0,0,105,73,74,
69,70,0,0,0,0,0,0,0,0,0,0,0,0,0,48,0,0,0,0,0,0,0,0,39,0,0,0,0,0,0,0,0,48,0,48,0,0,0,0,0,0,0,0,0,0,0,0,0,100,101,0,111,112,111,112,47,47,55,56,103,104,65,66,
77,78,0,0,0,0,0,0,0,0,0,0,0,0,0,48,0,0,0,0,0,0,0,0,39,0,0,0,81,82,0,0,0,48,0,48,0,0,92,93,0,0,0,0,0,0,0,0,119,120,119,120,103,104,103,104,17,18,63,64,111,112,73,74,
71,72,0,0,0,0,0,0,0,0,0,0,0,0,0,48,0,0,0,0,0,0,0,0,39,0,0,83,84,9,10,0,0,48,0,48,0,0,100,101,0,0,0,0,0,0,0,0,117,118,117,118,111,112,111,112,25,26,55,56,103,104,65,66,
79,80,0,0,0,0,0,40,0,0,0,0,0,0,0,48,0,0,0,0,0,0,0,0,39,0,5,6,3,4,87,88,0,48,0,48,97,98,3,4,0,0,0,0,0,0,0,0,125,126,125,126,119,120,119,120,19,20,63,64,111,112,73,74,
67,68,0,0,0,0,0,40,0,0,81,82,0,0,0,48,87,88,85,86,21,22,23,24,39,0,13,14,11,12,7,8,3,4,3,4,5,6,11,12,3,4,0,0,0,0,0,0,117,118,117,118,127,128,127,128,27,28,17,18,119,120,65,66,
75,76,0,0,0,0,0,40,0,0,39,9,10,0,0,48,3,4,3,4,29,30,31,32,3,4,91,91,91,91,15,16,11,12,11,12,13,14,91,91,11,12,3,4,85,86,89,90,125,126,125,126,3,4,3,4,5,6,25,26,127,128,73,74,
5,6,7,8,7,8,3,4,3,4,3,4,3,4,5,6,11,12,11,12,3,4,7,8,11,12,91,91,91,91,91,91,91,91,91,91,91,91,91,91,91,91,11,12,7,8,5,6,3,4,3,4,11,12,11,12,13,14,7,8,3,4,3,4,
13,14,15,16,15,16,11,12,11,12,11,12,11,12,13,14,91,91,91,91,11,12,15,16,91,91,91,91,91,91,91,91,91,91,91,91,91,91,91,91,91,91,91,91,15,16,13,14,11,12,11,12,91,91,91,91,91,91,15,16,11,12,11,12